0000010000002
0000234434234
0011100010100
0424004140241
0020021040240
2024040140120
9219412949421
2041201401042